NOOP    1
ADD     2
ADD.D   2
DIV     2
DIV.D   2
SUB     2
SUB.D   2
MUL     2
MUL.D   2
L       2
LI      2
S       2
L.D     2
S.D     2
BEQ     2
BNEQ    1
BGTZ    1
BLTZ    1
MOVE    2
BEQ.D   2
BNEQ.D  1
BGTZ.D  1
BLTZ.D  1
MOVE.D  2
--
loads 3
stores 3
intadds 3
fpadds 3
intmuls 2
fpmuls 2
intdivs 2
fpdivs 2